R  1920 1080
NO ./Textures/north_wall_texture.xpm
SO ./Textures/south_wall_texture.xpm
WE ./Textures/west_wall_texture.xpm
EA ./Textures/east_wall_texture.xpm
S ./path_to_the_sprite_texture.xpm
F 200,100,50
C 0,150,200

        1111111111111111111111111
        10000000000110000000000001
        1011000001110000002000001
        1001000000000000000000001
111111111011000001110000000000001
100000000011000001110111101011111
11110111111111011100000010001
11110111111111011101010010001
11000000110101011100000010001
10002000000000001100000010001
10000000000000001101010010001
1100000111010101111101111000111
11110111 1110101 101111010N01
11111111 1111111 111111111111
